{
  "id": "sect_main",
  "name": "宗门大殿",
  "tiles": [
    [1,1,1,1,1,1,1,1,1,1,1,1,1,1,1,1,1,1,1,1],
    [1,0,0,0,0,0,0,0,0,0,0,0,0,0,0,0,0,0,0,1],
    [1,0,0,0,0,0,0,0,0,0,0,0,0,0,0,0,0,0,0,1],
    [1,0,0,0,0,0,1,1,0,0,0,0,1,1,0,0,0,0,0,1],
    [1,0,0,0,0,0,1,0,0,0,0,0,0,1,0,0,0,0,0,1],
    [1,0,0,0,0,0,0,0,0,0,0,0,0,0,0,0,0,0,0,1],
    [1,0,0,0,0,0,0,0,0,0,0,0,0,0,0,0,0,0,0,1],
    [1,0,0,0,0,0,0,0,0,0,0,0,0,0,0,0,0,0,0,1],
    [1,0,0,0,0,0,1,0,0,0,0,0,0,1,0,0,0,0,0,1],
    [1,0,0,0,0,0,1,1,0,0,0,0,1,1,0,0,0,0,0,1],
    [1,0,0,0,0,0,0,0,0,0,0,0,0,0,0,0,0,0,0,1],
    [1,0,0,0,0,0,0,0,0,0,0,0,0,0,0,0,0,0,0,1],
    [1,0,0,0,0,0,0,0,0,0,0,0,0,0,0,0,0,0,0,1],
    [1,0,0,0,0,0,0,0,0,0,0,0,0,0,0,0,0,0,0,1],
    [1,0,0,0,0,0,0,0,0,0,0,0,0,0,0,0,0,0,0,1],
    [1,1,1,1,1,1,1,1,1,1,1,1,1,1,1,1,1,1,1,1]
  ],
  "collision_tiles": [1],
  "enemies": [
    {"type": "spirit_rat", "pos": [5, 5]},
    {"type": "spirit_rat", "pos": [14, 8]},
    {"type": "demon_cultivator", "pos": [10, 12]}
  ],
  "portals": [],
  "items": [],
  "npcs": [],
  "music": "",
  "realm_require": ""
}
