{
  "name": "测试地图",
  "tile_size": 32,
  "tiles": [
    [1,1,1,1,1,1,1,1,1,1],
    [1,0,0,0,0,0,0,0,0,1],
    [1,0,0,0,0,0,0,0,0,1],
    [1,0,0,1,1,1,0,0,0,1],
    [1,0,0,1,0,1,0,0,0,1],
    [1,0,0,0,0,1,0,0,0,1],
    [1,0,0,0,0,0,0,0,0,1],
    [1,1,1,1,1,1,1,1,1,1]
  ],
  "collision_tiles": [1]
}
